....&.................&.
....&...................
........................
..........&...........&.
..@.......&&..........&.
++++++++++++++++++++++++
########################
########################
########################
########################
