........................
........................
........................
..........&...........&.
..@.......&&..........&.
++++++++++++++++++++++++
########################
########################
########################
########################