.........................
.........................
.........................
.......................#.
..@....#...#...........#.
#########################
#########################
#########################
#########################
#########################