........................
........................
........................
&..........&............
&.@.......&&......&.....
++++++++++++++++++++++++
########################
########################
########################
########################
