&.......................
&.......................
&.......................
...........&............
..@.......&&.......&....
++++++++++++++++++++++++
########################
########################
########################
########################
