.&......................
.&......................
...........&............
...........&..........&.
..@.......&&..........&.
++++++++++++++++++++++++
########################
########################
########################
########################
