........................
........................
.................&......
.......&.........&......
..@....&.........&&.....
++++++++++++++++++++++++
########################
########################
########################
########################
