&..................&....
...................&....
............&...........
&...........&&..........
&.@........&&&..........
++++++++++++++++++++++++
########################
########################
########################
########################
