........................
........................
............&...........
............&&.........&
..@........&&&.........&
++++++++++++++++++++++++
########################
########################
########################
########################
